#######################
#@EEEEG    E     E G###
#######             ###
#    G   E  E G  E  BD#
#                 #E###
#   E      G     E#S###
#######################