##########################
#@EEEEEEEEEEEEEEEEEEEEEEE#
# #EEEEEEEEEEEEEEEEEEEEEE#
# #EEEEEEEEEEEEEEEEEEEEEE#
# #EEEEEEEEEEEEEEEEEEEEEE#
# #####################E##
#                EE EE BD#
##########################